#############################
#...#...#.....$.............#
#...#.#...#..##.............#
#.....#.#.##.#..............#
#..####.#..###..............#
#...#...##.#................#
#.#.#.###....##.............#
#.#.###...####..............#
#@......#...................#
#...........................#
#...........................#
#...........................#
#############################