#################################
#...#...#.....$.................#
#.#.#.#...#..##.................#
#.#...#.#.##.#..................#
#.#####.#..###..................#
#...#...##.#....................#
#.#.#.###....##.................#
#.#.###...####..................#
#@#.....#.......................#
#...............................#
#...............................#
#...............................#
#...............................#
#...............................#
#...............................#
#...............................#
#################################