##############D##################
#...#...#.............#.........#
#.#.#.#...#..##.......#.........#
#.#...#.#.##.#........#.........#
#.#####.#..###........#.........#
#...#...##.#..........#.........#
#.#.#.###....##.#######.........#
#.#.###...####..................#
#@#.....###.....................#
#...............................#
###############....##############
#...............................#
#...............................#
#...............................#
#...............................#
#################################